20,10
1,1,1,1,1,1,1,1,1,1,1,1,1,1,1,1,1,1,1,1,
1,8,15,15,15,15,15,15,15,15,15,15,15,15,15,15,15,15,8,1,
1,15,1,1,1,1,15,1,2,2,2,2,1,15,1,1,1,1,15,1,
1,7,1,2,2,1,15,1,4,5,6,3,1,15,1,2,2,1,15,1,
1,15,1,2,2,1,15,1,1,1,1,1,1,15,1,2,2,1,15,1,
1,15,1,1,1,1,15,15,15,15,15,15,15,15,1,1,1,1,15,1,
1,15,15,15,15,15,16,1,1,1,1,1,1,15,15,15,15,15,15,1,
1,15,1,1,1,1,15,1,1,1,1,1,1,15,1,1,1,1,15,1,
1,8,15,15,15,15,15,1,1,1,1,1,1,15,15,15,15,15,8,1,
1,1,1,1,1,1,1,1,1,1,1,1,1,1,1,1,1,1,1,1